[
    {
        "level": 1,
        "goal": 6,
        "goalType": 3,
        "moves": 12,
        "lvl": [
            [7, 8, 9, 10, 4, 3, 1, 2, 4],
            [6, 1, 2, 4, 1, 2, 11, 11, 6],
            [3, 3, 1, 5, 2, 7, 3, 1, 2],
            [2, 1, 3, 3, 1, 5, 4, 5, 4],
            [2, 2, 5, 1, 6, 2, 6, 11, 2],
            [11, 3, 6, 1, 1, 3, 11, 2, 2],
            [3, 6, 4, 2, 2, 4, 1, 11, 11],
            [2, 1, 6, 3, 2, 6, 5, 3, 4],
            [1, 2, 3, 3, 5, 6, 7, 8, 9]
        ]
    },
    {
        "level": 2,
        "goal": 4,
        "goalType": 7,
        "moves": 20,
        "lvl": [
            [1, 4, 9, 8, 5, 1, 7, 8, 6],
            [1, 6, 8, 8, 2, 3, 7, 7, 9],
            [7, 1, 2, 1, 1, 4, 1, 8, 5],
            [5, 5, 4, 1, 2, 1, 3, 5, 9],
            [1, 3, 3, 2, 5, 6, 2, 6, 4],
            [2, 7, 6, 6, 4, 9, 6, 3, 3],
            [3, 2, 5, 7, 5, 9, 4, 1, 2],
            [1, 4, 7, 3, 7, 5, 7, 8, 7],
            [8, 6, 3, 1, 7, 6, 7, 1, 1]
        ]
    }]